11111111111
1E00000C001
10101010101
10111010101
1P00C00C0C1
11111111111