11111111111
1E00C00C001
101010101F1
10111010101
1P00C00C0C1
11111111111